? KOHGPBDBBJI : network class

player = IIEKJBMPELC
amount = AMMANIHDKKA
initialState = BILBBBFMCOB
reader = ALMCIJKELCP
writer = AGLJMGAODDG
SwitchSystem = ILEEIKKPGLG
Wire = HDJCCNCONCK
color = HHJCOBKGBFF
pc = NMEAPOJFNKA
playerId = NHOCGFDHKKK
taskId = DEFPLPHJLBN
taskTypeIds = NHAFLOEMFKF
skin = ADLNPGGEOHF
petId = FHPHKIBKMHO
PlayerInfo = DCJMABDDJCF
GetPlayerById = GILHJJNOLBC
id = HKOIECMDOKL
name = MLBHDDBAPLO
chat = GEPPDHDDCJC
TaskInfo = CAAACHLJJNE
c_DisplayClass21_0 = KPBPEBDFFPM
callId = HKHMBLJFLMC
DisconnectReasons = GHMBCKNECJF
reason = OECOPGMHMKC
GameStartManager = ANKMIOIMNFE
sec = NOGEHEKPMCA
GaugeRandomizer = JBGDFNAKNAK

PlayerTask = PILBGHDHJLH
task = OJGILIGMHKL
EnterCodeMinigame = GOBEMNFEJPH
i = GODDGFEAAMO
VendingMinigame = BEBLBBMJPKA
slotId = FCEHDDLOLNL
drink = GBHILLNNIEA
WeatherMinigame = GOABAMJHLMA
ProcessDataMinigame = HGNNAOACEDD
AcceptDivertPowerGame = BBMAHLBBOGP
t = KKHLLNAKPFM
CoDoSwitch_d_9 = NCJKOFEBCBF
c_DisplayClass10_0 = MBAOCNCLNMC ???
PbExileController = OOLIGABMHMI
DiscordManager = BFJAOBKOKOH
numPlayers = FAEAEAMNEEO
gameId = DNJDMIFKMEP
mode = NCMHPMFCNFA
CoJoinGame_d_14 = JDNGGOEAOLG
ShhhBehaviour = KINKOIBEGCF
duration = KNJBBEFMHBI
p = EIMCHPMHNMA
vec = KDPFGPOPGAH
TextBox = HOHFKPCCMBI
pt = EAAENFJALCM
inputCompo = POJFAMBMOGL
input = CLLFJHHOOPP
TextController = NCJFENKILLN
ToggleButtonBehaviour = EKHIIKDIIBM ?
on = EHNJJAPKPMF ?
source = HLHMFLICGMB
canMove = MDKEGLADENC
target = CAKODNGLPDF
KillOverlay = CFKDGHIEFFA
killer = CPFLLCANGCB
victim = OHKJALIJBLO
OverlayKillAnimation = OAKKJMGJBGG
anim = BNMFALPGNKE
killAnimPrefab = OKPHGNCPCOF

SceneChanger = HNLPLIHOHOP
HowToPlayController = DBMPHGJPLEJ
del = JPPDJPKHPKP
PassiveUiElement = DCHBCACCFGG
dragDelta = IHNINMAIEEJ
Scroller = CIAACBCIDFI
ProgressTracker = IOLACDMHKAL
isActive = KAGOIINIBKN
ReportButtonManager = HFFEFDMADEK
SystemTypes = LJFDDJHBOGF
buffer = JOGAAOKNOJB
hitCount = FDNIBOOPOCH
DiscussBehaviour = MHFCOFCOKOO
ToggleButtonBehaviour = EKHIIKDIIBM
format = JDIHAANHFGC
hMem = BJBDLAIDABC
ClipboardHelper = BDKBJPMDNOB
GetClipboardString = BJPNOJAJNDD
GlobalSize = PFIMJBDLAJB
GetClipboardData = JJMDILKPPAF
IsClipboardFormatAvailable = PCKACEPDCFD
hWndNewOwner = MAAMFOJHFKJ
OpenClipboard= EFDGJPADHMI
CloseClipboard = HFDFJLOEMBN
GlobalUnlock = GGNMIIKKMFI
GlobalLock = DFLEFJLMJDC
UseButtonManager = LJKIJNFBBHH
value = HIJOHCLAKMG
VerticalSpriteGauge = FGBFCMLICKE
CustomNetworkTransform = LNBAPKHKDPG
newSid = JFHHDBEJLFP
prevSid = GAHCCFAHAKH
position = LLNOEOIBDIM
ChatLanguageSet = NEANNPIFIGK
flag = KMOIAAJNJPC
ServerInfo = PLFDMKKDEMI
obj = ABKMBGEIPKL
parts = EBKIKEILMLF
RegionInfo_1 = OIBMKGDLGOG
ServerManager = AOBNFCIHAJL
servers = MHFBFNBCCEA
networkAddress = OMCIBILGCMH
CrystalBehaviour = BBBHAHNACAJ
delay = OKLPFPIPCDB
CrystalMinigame = BDJEMCMOINP
startAt = EBNAHHDDOPI
inBox = CCBAOJNKGID
SortGameObject = PEINHEPIKMN
dropSound = OAIHOIGLDFP
SortMinigame = FNGEBHEJDNK
dropped = LJIAILJJEME
DiagnosticGame = EHICKEJAJFI
num = GNONFJPCPKG
f = PPOLIMDFHNL

TowerBehaviour = ENLGGDPHDIH
UploadDataGame = AGACKJGHKEP
CardSlideGame = BJIOFILJGOB
BallonBehaviour = CGBFONGIPAK
AutoParallaxController = CGBFONGIPAK
CoDoAnimation_d_8 = PDOEAKANLPP
DialBehaviour = KNBKKLEEPKG
angle = BIAJEHINFGA
RadioWaveBehaviour = JDNHBOCBEMN
dt = GDMHDAJAPDD
Constants = CAMOCHFAHMA
GetBroadcastVersion = JJPPIHPNPBF
year = DDNAIFKNGDG
month = OHGJONBIGPM
day = DNKLKMKCNKK
rev = ANLDMBNGAAD
GetVersion = JFFFOGICPMM
GetBroadcastVersionBytes = CJIJJNBOOMB
Controller = ANAACMGELPG
DragState = IELLIHILNHG
TouchState = CLHMEMNMPKD
coll = BLJNAEIIJEB
AlphaBlink = KGOBKLFFKML
c = IIIHDINGDMH
AlphaPulse = DCFGKBCGPPH
DefaultPool = CCAKKBBNNPD
PoolableBehavior = CCLDIACANAF
self = HCENJMMLKNA
time = NPHJCKDCKDD
Effects = MFGGDFBIKLF
Wait = MGFNMJEJMFL
items = KBIIEDBBDHB
todo = CJGPLOIFNCF
ForEachChild = ECGJFOOEFHN
HashRandom = GIDLMNJNKEH
Next = FCLCMLGMLDP
maxInt = MPDOLIINCPM
minInt = ICHJLAAILJF
FastNext = HKNAIIJHLHE
IObjectPool = OBFGHNNNJPE
SubStringReader = NHPBHELMCLJ
SubString = KBFICJJODPF
v = AIAMLABDANE
subString = EDGIFDCJFGL
delim = MPFLOIOMGOP
SafeSplit = BBBDAHIPFAP
action = BHDOCBBIJEA
overextend = HINBLHCIABK
TextRenderer = AELDHKGBIFD
ColorFade = OLLKNECIIKK
PulseFade = AEPMCIGJPOC
ScaleIn = LNMDEOEPIII
Overlerp = GOIEIFDEFGA
Lerp = JAAHHGGAOBJ
height = JICLALJJIDL
Bounce = ACDFICBKICN
taper = PPIMBPFMAHE
Shake = LMOHJJHDCDO
SwayX = MAOMAPPAJEG
halfWidth = IHBLFDIPDMN
Sequence = IINCFNGIGPA //not sure
All = NFPGHHFPFLE //not sure
Bloop = NJOHOOJGMBC
ElasticOut = HLCPGOIICKG
Extensions = GJEEJMCDOLB
chars = GINBHBEBGCI
ToInteger = FLKNAACPCMA
alpha = BMKFFDCILBE
bit = NDBKGMFBFMO
HasAnyBit = EICNIOFEEMF
RemoveAll = PIPJAFLLBFI
TrimEnd = OKOAPEOEBCF
ToTextColor = LKGGELPHLME
HasBit = NGAKIAPEOCJ
Mul = GOPPHNDJHFE
b = NNMIKJDPHMI
Inv = MCKAPPEEOIL
a = IOEIMBPLJDJ
Warp = JCLALAMOPOM
widthAndHeight = DHACGCJALBH
max = BCDHFMIFJAI
MapToRectangle = CLOKOEBGIMC
vector1 = DPFKBFCACHG
vector2 = ENBEGCKNCEI
degress = NPPACAFHMPC
Rotate = MNCOKMCOPII
RotateY = PIOIOHGAEGN
s = CPMMELOIDJJ
IsNullOrWhiteSpace = GAKHNHKGFPE
z = BGGGGCJFACM
SetZ = CPDENLNGHKB
GameObjectExtensions = BJFINMOMECG
LookAt2d = GPKGNGGCJCH
DestroyChildren = FIPBMFDLAHJ
output = DJJFGEMHJEI
start = HAJDIADKCAG
lenght = LENMPPHLMOF
MeshRendererExtensions = ECCMDPNEPAL
ObjectPoolBehaviour = FJBFFDFFBFO
prefab = LGFCHNHBEMJ
Palette = LOCPGOACAJF //0x00208BA0
radius = EOBHFHLJLKA
layerMask = JJEENKFBHHJ
useTriggers = NGMMLDPDBMG
mag = CACAABFFKDO
dirNorm = JKFILKKGICM
CircleContains = FCLLHJJDKNI
AnythingBetween = HPFJAJHFGOF
AnyNonTriggersBetween = IIPMKCELMED
BoolRange = OJHJPFFKEFP
min = PHAEFENAGPN
array = KICKOHKGPLA
y = MEBKIGOEHFB
z = BGGGGCJFACM
width = GBLAKPCJLLM
SetResolution = FKNDLMBEAKP
ToggleFullscreen = POMDIAEGOHN
ResolutionManager = OIFAFCPKADN
SpritePartictle = PHEEICPHHPP
StringExtensions = JEEMCHOJLJI
FontCache = EIPJOEEOFOO
dataSrc = AKICAANGHDP
eData = HCFIMFMMNPM
last = PENFJFPIMHA
cur = MICKBBOMCGK
FontLoader = HCBLPFOBBJE
IntToChannels = LAJNOPGODGL
FromBinary = CDBNAKPOCIA
TextLink = PHINFDJKKJM
from = IMBFJHBKJBM
to = OLPJFOMGCMD
TextMarquee = IIOGJOCJJKH
baseX = DHDDBFIKKBI
lineStart = KENOOBIPEPK
scale = JAMECKJEOAC
verts = OBHEDCNDPGN
displayTxt = NHNBNGHFJBH
maxWidth = IEGOPNMOMEE
TwitterLink = ANEKODAKPJB
VersionShower = BOCOFLHKCOJ
WaitForLerp = PICPAHLDCMC
buf = ANOCGEOFEHK
XXHash = DNPPIBIMNPL
read_value = KJNANBKONDO
count = JFFMDPKEEJG
CrossFadeImages = KMHNKJPPPDL

TuneRadioMinigame = JAIDHHBBKPG
EndGameManager = ABNGEPFHMHP
success = AOEEKHMFIAK
ExileController = CNNGMDOPELD
exiled = LNMDIKCFBAK
tie = BBJAEDLJIED
IntroCutscene = PENEIDJGGAF
yourTeam = KADFCNPGKLO
isImpostor = AMDGJKPGEPJ
MiraExileController = JCAGPJAFPIK
DateHide = GAPHCHHMMGD
DetectHeadset = KCHNLKKAIBH
DetectTamper = PFGKMEJCLEJ
DisconnectPopup = HNAHDKBECLC
message = PJICJIHPFGG
userId = KJHNMCBBBIF
joinSecret = OFNBDDNPGJG
scene = NDIDGHDKEHF
DoorConsole = NBJABHGBLDK
canUse = HPLJBLJOCKO
couldUse = KBFCKGNGJED
mainTarget = OPFNEGKJDLB
even = HKCGLAIDJHF
DotAligner = FFEFOMDLFDA
DragSpecimen = LCFHINBJCKH
DripBehaviour = EGJHPIOMHPF
EdgeTransition = LOACFCFPDEF
DiverPowerMetagame = HKKCBFANDOA
DiverPowerMinigame = ADPAMIHKLNA
c_DisplayClass7_0 = OBNMJHCFPAL
SweepMinigame = DDMNAOJDFMF
FlatWaveBehaviour = DCAMNBLEIEE
SwitchMinigame = HFBAHEBIIFA
switchIdx = FMIDEMBBJPM
deltaTime = INJIGFHIDCA
reset = NOOFMOEGFIL
targetWorldPos = MGOHFENHEED
pos = JNPBFGJCCLC
WireNode = MKKCEDPELOC
WireMinigame = JNJCKINBIJK
AlignGame = ADJODHAGPFA
EngineBehaviour = JANCELDDODD
pitch = AMELCKGDFKK
SteamBehaviour = FLJLJCANPMP
MultistageMinigame = EPCNDEPNOCB
RefuelStage = PDAFLLKODJH
FollowerCamera = KGIKNCBGPFJ
severity = JPHNCOBPLAG
FreeWeekendShower = BAEKNNAJNLM
FreeplayPopover = FPGNFPCFHAA
hat = BCDGGGHFLCC
hatId = CAEHOLMOBNA
skinRend = FADFHCFIHAK
HatManager = OFCPCFDHIEF
skinId = EPBONDIDGDF
PetBehaviour = DLMDFGBMGPC
CloudGenerator = MINMAKCOGKM
dir = HNODFBOGLNB
pointx = AHPHEFGDPDG
pointy = DNLDEODGGIE
AuthGame = PABHKMHOCMG
DeconControl = DFIPBAGGCNO
upper = GFHJCPJNHPC
DeconSystem = KMBHHGDGOKO
States = IHBEJBGPOAK
DecontamNumController = BIBKPBKHDDC
curSecond = GDPBLKLIBJK
maxSecond = GFDEHMHHBPP
LogEntryBubble = GCBEBENEDBJ
SecurityLogGame = MGAGMMKGMEE
SensorDoor = CICPHMFOCJH
code = KHAINGPFFGE
VendingSlot = OBMEJNELBNF
sliderOpen = KLELCCCMJCL
drinkShake = LDHGBCIOGMH
drinkLand = JLLAALAKNGL
HoverAnimBehaviour = HEEMGBKHNOG
DummyConsole = LOJAKICKHJM
FingerBehaviour = AONIJDDEMMD
PlayerAnimator = GIFADNNODPB
worldPos = ALCLHFLGKPK
relax = CKBOMNBEDCJ
tolerance = HJBNKNJJNGB
Scene0Controller = FBHJPILBFBJ
boy = DHCGPGHFENI
Scene1Controller = PAIKHDOPENC
idx = AOONHAJNJLD
consoleid = EKPNGOLDPAA
AspectPosition = CKFHGGLODEF
aspect = MKPDMABICHG
relativePos = ADEHBMPHFGD
cHeight = GEHFKMCJMLP
alignment = MLMGBPOKPCC
AspectSize = CBLBNKCMPIO
parentPos = EAFDFKDJBBP
sprite = BMEMMOPPDNA
BanMenu = CPKHIGCPOEM
BanButton = OBEDBEIDCNL
oldNum = BFPJOHNKEKP
newNum = DNPFHLDHLGC
newVotes = LELAPFBLDFI
client = EENGMFBIGOC
ban = BLJAPOPFHEI
show = IPCDDFNLBJF
c_DisplayClass8_0 = KEHOBJCJONP
VoteBanSystem = BEIIFNNNDIC
clientId = GKLCLMNGEHC
srcClient = NHMMAFLGDAP
ButtonBehaviour = LMPPCHIGNOI
ChatBubble = KILPMABPOEH
playerName = EFLLLKGLOKH
isDead = BMKBNGOGADC
voted = AEKNKMPANIJ
ChatController = GEHKHGLKFHE
visible = HEHFCDGPEPD
srcPlayer = JLGMGDHGNNE
ChatNoteTypes = AHIDPDEBPDC
noteType = IAGNPOCAGCI
sourcePlayer = KMCAKLLFNIM
chatText = PGIBDIEPGIC
MeetingHud = OOCJALPKPEP
meeting = LJDCJKBHHMO
DialogueBox = HNKKBIFCNIF
dialogue = LAJLJHHHMPE
HorizontalGauge = JPCNLCINALA
HorizontalSpriteGauge = OPCKCBEGIEI
HudManager = PIEFJFEOGOL
type = BJJLFKLPBEM
shhh = NOAHCIHCNBO
size = MCOMGMHOBDJ
reporter = CNJAHAOLBLI
text = OLNAEHKDFFB
DemoKeyboardStick = FHKNBBHEJBB
FingerBehaviour = AONIJDDEMMD
finger = NNAFDKHNGLB
velocity = JEJDOBIONAK
syncFinger = MKCGMMGMBCG
KeyboardJoystick = ADEHDODPMHJ
ScreenJoystick = OAJOCHMLEDJ
VirtualJoystick = EKDCMDLLOGO
CooldownHelpers = LBDKCJEDCIE
myRend = MKIDFJAEBGH
SetCooldownNormalizedUvs = LOPELFKNDPI
timer = JECMPCICNEB
maxTimer = HFOEEFJGACL
KillButtonManager = MLPJGKEACMM
InfectedOverlay = JBADOLKBGLA
MapCountOverlay = OIIPHLHIHAL
InfectedOverlay = JBADOLKBGLA
MapRoom = JIPAPBFIHOA
perc = DCEFKAOFGOG
MapTaskOverlay = HDBBOBCLALK
PooledMapIcon = CGGOGEJBECA
mapIcon = JBDLFDKFCML
BlockedWords = AKPNPAHKJIN
CensorWords = PBBPJAPKHEN
letter = IKFHMHKBGCL
LenghtCompare = FIKEGIHKGHO
x = JPKJOFMMIIH
LetterTree = JFGMHCMBBGH
inputStr = CBEFFFMAAPJ
word = DOLBDMPBNNI
LetterNode = OPALJJGNHFN
previous = LLEMPGOGJGA
postDupes = PEEEPCFDFIC
postBreak = IGPMMLCKFDA
exactStart = IOBFMLLBPEE
node = JFLIAABMBPE
l = LMNLHBKHIJC
MeetingHud = OOCJALPKPEP
suspectStateIdx = ELLMEECGHCN
states = GPOAEGEJFCK
PlayerVoteArea = HDJGDMFCHDN
tie = BBJAEDLJIED
targetPlayer = MKOEHLABEPN
srcPlayerId = LLBNLKGCCLF
suspectPlayerId = IGHCLNJMJEO
MeetingRoomManager = LHLNHLKEHFK
isMe = PKHKNNGGOLB
didReport = GDGIOMDGNKO
state = DCCFKHIPIOF
NameTextBehaviour = JEPEOBEIFPH
NotificationPopper = CBFHNKKKMKP
item = IMALJKOJJBI
ButtonDownHandler = KCMCPOIGKKC
ButtonRolloverHandler = MGLJBDCGENL
PassiveButton = HHMBANDDIOA
button = NCPCFIJKAAM
col = GPCJAAJKMEP
IFocusHolder = AAPBLFDKALL
focusHolder = MIIBCFHINAL
getDownTouch = FAILFFPEMCA
PassiveButtonManager = BNJMFNEJJFH
DepthComparer = HHOGJKFEDLB
RoomTracker = IJCMADIPDHJ
newRoom = CLMEEELBEJC
on = EHNJJAPKPMF
TransitionOpen = FMLJMBMEHAI
IUsable = CMCLOPELAIG
VerticalGauge = MIIBHKJHBEJ
minSid = AOJKAABOMOG
KeypadGame = PBFOPOAPOLA
LeafBehaviour = DLLKBDEPIPE
LeafMinigame = JEHNFCDHMHH
leaf = CNKOKOJNOKA
AdDataCollectScreen = NPKMJIFMIFG
e = MGJNFEHIICO
AnnouncementPopUp = MJONEDLPIDC
sender = JAMOJLPPGEH
DataReceivedEventArgs_1 --> DataReceivedEventArgs
data = NJJBJMCBDCJ
gameIdString = NCNNAGHIGEE
TotalGameData = CHHLKKJJOJP
totalGames = JMLEGPELMHG
availableGames = JHLNMHMKEHB
showAd = EMAKAHIFLDE
GameOverReason = AIMMJPEOPEC
gameOverReason = DOAMFOGADEF
clientData = AGDOBLPOBBH
client = EENGMFBIGOC
currentScene = FAPAHLBAECM
ChatLanguageButton = FPBHBCACMFK
ChatLanguageMenu = HMGAMLOJCOI
language = JHPOFGFLLMD
CreateGameOptions = LMAMILNDCOG
CreateStoreButton = JHPKPOKJCFO
CrewVisualizer = JBONHPPINPM
numImpostors = JCKPBEBOFDA
mapid = BBCCGKOMLJF
ExitGameButton = IOJNBAOJLIE
FindAGameManager = DCGOPMPLEEJ
FindGameButton = OGBEMFKNADD
GameSorter = CBBBHNOBGEM
GameDiscovery = HINOBICFJIF
packet = KMPAOIDIDKJ
fromAddress = HMHOPPDOMKI
gameNameParts = BCCNJGKGMEL
HostGameButton = CFOLJDACCCL
JoinGameButton = LMPDFADEDCF
ColorChip = HHCPGBKDLEE
CustomPlayerMenu = AANMMDGMFEL
tab = JDBBMFAJIII
GameSettingMenu = JCLABFFHPEO
HatsTab = OLOMLDDGGPP
LobbyBehaviour = PFLIBLFPGGB
OptionsConsole = DIFMFEECAGI
mainTarget = OPFNEGKJDLB
PetsTab = GNMKPOHCINP
pet = IFBFBBLDDBK
PlayerTab = MAOILGPNFND
colorId = NPFHOONFFDI